11111111111111111111
100C0C00110C00C00001
10C0000011000010C001
1000C000110E0010C001
10000C00110P001000C1
100000C0111111100C01
100000C000000C000001
10000C0000CCC0000001
1000C00C000C000C0001
11111111111111111111
