111111011
00P00P001
1E00C1111
111111111
~
