111111111111111
10E00P000000001
100C000C000C0C1
10CC00C0000C001
111111111111111
