111111111111111
10C000E00000001
100C00C000CC001
10C00P00C0C0001
111111111111111
